# 2024-06-09 - @JimMcCauley - Grand Go the Years

Randy Newman - I Think It's Going to Rain
John Cale - Ghost Story
Alan Stivell - Marig Ar Pollanton
John & Beverley Martyn - Auntie Aviator
The Yardbirds - White Summer
Love - Maybe the People Would Be the Times or Between Clark and Hilldale
Tony Bennett - When I Look in Your Eyes
Molly Drake - How Wild the Wind Blows
Nick Drake - Blues Run the Game
Astrud Gilberto - Beginnings
Bee Gees - Birdie Told Me
The Zombies - Time of the Season

# 2025-11-23 - (collage of) Groove of ESSR 1-3: Funk, Soul, Disco, Jazz and Easy Listening from Estonia 1971-1984

Collage - Mets Neidude Vahel [Forest Among Girls]
Raivo Parind & Ansambel Eufoonia - Hei, Päike! [Hey, Sun!]
Heidy Tamme - Neiu Väike [Young Maiden]
Tiiu Varik - Näed Vaid Oma Silmi [You Only See With Your Own Eyes]
Velly Joonas - Stopp, Seisku Aeg! [Stop, Time Stand Still!]
Ülle Ernits & Admiral - Ma Tahan Olla Siin [I Want to Be Here]
Marju Kuut - Üksi, Kuid Vabana [Alone, But Free]
Uno Naissoo - Marss-Ekspromt [March Impromptu]
Eesti Raadio Estraadiorkester - Mälestuste Teel (Instrumental) [On Memory Lane]
Jaan Kumani Instrumentaalansambel - Mind Veel Ei Ole (Instrumental) [I'm Not Here Yet]
Els Himma - Veerev Päev [Windy Day]
Magnetic Band - Liiklus [Movement]
Teravik - Hoia Ennast Koos [Keep Yourself Together]
Tõnis Mägi & Music Seif - Metsaneid [Forest Maiden]
Tarmo & Toomas Urb feat. Vanemõde - Välgud Peeglis (Short Version) [Flashes in the Mirror]
Tõnis Mägi & Music Seif - Sa Haara Kinni Mu Käest [You Hold My Hand]
Marje Aare - Sunny
